
SO text.txt
NO text.txt
WE text.txt
EA text.txt																																																																										

F 11,11,11
C 11,11,11		


   11111111111111
111     101011011
101111111111111111
1110100111111101
101N010111111 11
11111111