SO ./textures/crypt0.png
NO ./textures/BrickLightGrey(1).png
WE ./textures/BrickFireRed.png
EA ./textures/brick_dark_2_8.png

F 255,2,11
C 11,11,					166

111111111111111111111111111111111111111111111111111111111111111111111111111111111111111111111111111111111111111111111111111111111111111111
111111110000000011000000000000111111111111111100000000000000000000000000000000000000000000000000000000000000000000000000000000000000000001
110010010000000001000000000000000000000000000000000000000000000000000000000000000000000000000000000000000000000000000000000000000000000001
1101111110110000000000000000000000000000000000000000000000000000W0000000000000000000000000000000000000000000000000000000000000000000000001
100000000011000000110111111111111110000000000000000000000000000000000000000000000000000000000000000000000000000000000000000000000000000001
111101111111110110000000100011001000000000000100000000001111111111111111111111111111111000000000000000000000000000000000000000000011111111
111101111111111111100111111111110001000000000000000000000000000000000000000000000000000000000000000000000000000000000000000000000000000001
111101111111110111000100000011110001000010001101010000000000000000000000000000000000000000000000000000000000000000000000000000000000000001
110000001101010111000000001010100001000000000000000000000000000000000000000000000000000000000000000000000000000000000000000000000000000001
100000000000000111000001111111010001000010001101010000000000000000000001111111111111111111111111111111111111111110000000000000000000000001
1000000000000000000101001 1111110000000000000000001000000000000000000000000000000000000000000000000000000000000000000000000000000000000001
110000011101010101110111111111000000000000000100000000000000000000000000000000000000000000000000000000000000000000000000000000000000000001
11110111 111010111011110110010000000000000000100000000000000000000000000000000000000000000000000000000000000000000000000000000000000000001
11111111 111111111111111111111111111111111111111111111111111111111111111111111111111111111111111111111111111111111111111111111111111111111

