
SO text.txt
NO text.txt
WE text.txt
EA text.txt																																																																												

F 11,11,11
C 11,11,11			


        1111111111111111111111111
        1000000000110000000000001
        1011000001110000000000001
        1001000000000000000000001
111111111011000001110000000000001
        1001100000111011111111111111
        11110111111111011100000010001
        11110111111111011101010010001
        11000000110101011100000010001
        10000000000000001100000010001
        10000000000000000101010010001
        11 0100111010101111101111000111
        11111111 1110101 101111010N01
        111  111 1111111 111111111111