
SO text.txt
NO text.txt
WE text.txt
EA text.txt

F 255,2,11
C 11,11,112


        111111111111111111111111111111
1111111100000000110000000000001111111111
1101100N0111000001000000111111
11001001000000000100000001111111
110111111011000001110000000000001
100000000011000001110111111111111
111101111111110111000000100011001
11111111111111111111111111111111
11110111111111011101010010001111
1100000011010101110000001010101
10000000000000011100000111111101
1000000000000000010101001 111111
110000011101010101110111110111
11110111 11101011101111011001
11111111 11111111111111111111
