
SO ./textures/studio0.png
NO ./textures/bnmoussa.png
WE ./textures/studio0.png
EA ./textures/studio0.png																																																																											

F  255, 122,0 
C 25, 25, 112			


1111111111111111111111111111111111111111111
100000000011000000000000000000000000001111111111
1000000000000000000000000000000000000011111101111
10010000000100000000000000000000000000001110001111
1100000000101000000000000000000000000010111101111111111
10000000000000000000000000000000000000001111011
1110000000000000000000000100011111111111111101
1111011111111101110101001000111111111111111111
11000000110101011100000010001
10000000000000000000000000N001
10000000000000000101010000001
1110100111010101111101111000111
11111111 1110101 101111010001
111  111 1111111 111111111111