
SO ./textures/studio0.png
NO ./textures/brick_dark_2_8.png
WE ./textures/brick_gray1.png
EA ./textures/sparkling_fountain.png																																																																										

F  255, 122,0 
C 25, 25, 112			


1111111111111111111111111111111111111111111
100000000011000010000000001000000000001111111111
100000000000000101000000000111100000000011111101111
1001000000010001011101000000000000000000001110001111
110000000010100100000100011111110010111101111111111
10000000000000011111110000000000000000001111011
1110000000000000000000000100011111111111111101
1111011111111101110101001000111111111111111111
11000000110101011100000010001
10000000000000000000000000S001
10000000000000000101010000001
1110100111010101111101111000111
11111111 1110101 101111010001
111  111 1111111 111111111111