
SO ./textures/studio0.png
NO ./textures/brick_dark_2_8.png
WE ./textures/brick_gray1.png
EA ./textures/sparkling_fountain.png																																																																										

F  255, 122,0 
C 25, 25, 112			


11111111111111111111111111111111111111111111111111111111111111111111111111111111111111
10000000001100001000000000100000000000111111111111111111111111111111111111111111111111
10000000000000010100000000011110000000001111110111111111111111111111111111111111111111
100100000001000101110100000000000000000000111000111111111111111111111111111111100000001
110000000010100100000100011111110010111101111111111111111111111111111111111111100000001
100000000000000111111100000000000000000011110111111111111111111111111111111111100000001
111000000000000000000000010001111111111111110111100000000000000000000001000001100000001
111101111111110111010100100011111111111111111111111111111100000001000010000100110000001
11000000110101011100000010001111111111111111111111111111110000000100001000010011000111
10000000000000000000000000E001111111100000000000000000000000000000000000000000000000001
111111111111111111111111111111111111100000000000000000000000000000000000000000000000001
10000000000000000100010000001111111110000000000000000000000001100000000001111111110001
11111111111111111111111111111111111110000000000000000000000001100000000001000000010001
11101001110101011110011110001111111110000000000000000000000001100000000001000000010001
11111111111111111111111111111111111110000000000000000000000001100000000001000000010001
11111111 1110101 1001110100011111111100000000000000000000000011000000000010000000100011
111111111111111111111111111111111111100000000000000000000000011000000000010000000100011
111  111 1110111 1101111110111111111100000000000000000000000011111111100011111111100011
111111111111111111111111111111111111100000000000000000000000000000000000000000000000001
11111111111101111110111111011111111110000000000000000000000000000000000000000001111111
1111111111111111111111111111111111111000000000000000000000000000000000000000000111111
1000000000110000100000000000000000000000000000000000000000000000000000000000000000111
1111111111111111111111111111111111111000000000000000000000000000000000000000000000111
1000000000000001010000000001111000000000000000000000000000000000000000000000000000001
1111111111111111111111111111111111111111111111111000000000000000000000011111111111111
1001000000010001011101000000000000000000001110001000000000000000000000011111111111111
1111111111111111111111111111111111111111111111111000000000000000000000011111111111111
110000000010100100000100011111110010111101111111100000000000000000000001
100000000000000111111100000000000000000011110111111111111000000001111111
1100000011010101110000001000111111111111111111111111111110000111
10000000000000000000000000000111111111111111111111111111111111
100000000000000001010100000011111111111111111111111111111111111
111010011101010111110111100011111111111111111111111111111111111


	