SO ./textures/crypt0.png
NO ./textures/BrickLightGrey(1).png
WE ./textures/BrickLightGrey(1).png
EA ./textures/brick_dark_2_8.png

F 255,2,11
C 11,11,166	


111111111111111111111111111111111111111111111111111111111111111111111111111111111111111111111111111111111
111000000000000000000000000000000000000000000000000000000000000011000000000000000000000000000000000000001
101000000000000000000000000000000000000000000000000000000000000000000000000000000000000000000000000000001111
111000000000000000000000000000000000000000000000000000000000000000000000000000000000000000000000000000001
101N00000000000000000000000000000000000000000000000000000000000000000000000000000000000000000000000000001
100000000011000000110000001100000011000000110000001100000011111111111111111111111111111111111111111111111
1111111101111111111111111111111111111111111111111111111111111111111111111
1111111111111