SO ./textures/crypt0.png
NO ./textures/BrickLightGrey(1).png
WE ./textures/BrickFireRed.png
EA ./textures/brick_dark_2_8.png

F 255,2,11
C 11,11,166	


1111111111111111111111111
1000000000000000000000001
1000000001000000000000001
100000000000000000000000111111111
111111111011000001110000000000001
1000000000110000011100000111111111
11110111111111011100000000001
11110111111111011101010000001
11000000000000000000000010001
10000000000000000000000010001
10000000000000000001010010001
11000001110101011111011110N0111
11110111 1110101 101111010001
11111111 1111111 111111111111