
SO ./textures/studio0.png
NO ./textures/brick_dark_2_8.png
WE ./textures/brick_gray1.png
EA ./textures/sparkling_fountain.png																																																																				

F  250, 122,0 
C 25, 25,112

1111111111111111111111111111111111111111111111111111111111111111111111111111111111111111111111111111111111111111
11111111111111111111111111111111110000000000000000000000000000000000000000000000000000000000001
10000000001000000001000000000011110000000000000000000000000000000000000000000000000000000000001
10000000001000000001000000000011110000000000000000000000000000000000000000000000000000000000001
1000000000000000000100000000011110000000000000000000000000000000000000000000000000000000000001
1100000010000000010000000000000000000000000000000000000000000000000000000000000000000000000001
10000000001000000001000000000011110000000000000000000000000000000000000000000000000000000000001
1110000000100000000100000111111110000000000000000000000000000000000000000000000000000000000001
111111111000000011111111111111000000000000000000000000000000000000000000000000000000000000111
1111111110000000111111111111110000000000000000000000000000000000000000000000000000000000001
1111111110000000111111111111110000000000000000000000000000000000000000000000000000000000001
111111111000000011111111111111000000000000000000N000000000000000000000000000000000000000001
1111111110000000111111111111110000000000000000000000000000000000000000000000000000000000001
111111111000000011111111111111000000000000000000000000000000000000000000000000000000000001
111111111000000011111111111111000000000000000000000000000000000000000000000000000000000001
111111111000000011111111111111000000000000000000000000000000000000000000000000000000000001
111111111000000011111111111111000000000000000000000000000000000000000000000000000000000001
111111111000000011111111111111000000000000000000000000000000000000000000000000000000000001
111111111000000011111111111111000000000000000000000000000000000000000000000000000000000001
111111111000000011111111111111000000000000000000000000000000000000000000000000000000000001
1111111110000000111111111111110000000000000000000000000000000000000000000000000000000000001
1111111110000000111111111111110000000000000000000000000000000000000000000000000000000000001
1111111110000000111111111111110000000000000000000000000000000000000000000000000000000000001
1111111110000000111111111111110000000000000000000000000000000000000000000000000000000000001
1111111110000000111111111111110000000000000000000000000000000000000000000000000000000000001
1111111110000000111111111111110000000000000000000000000000000000000000000000000000000000001
1111111110000000111111111111110000000000000000000000000000000000000000000000000000000000001
1111111110000000111111111111110000000000000000000000000000000000000000000000000000000000001
1111111110000000111111111111110000000000000000000000000000000000000000000000000000000000001
1111111111111111111111111111111111111111111111111111111111111111111111111111111111111111111