SO ./textures/crypt0.png
NO ./textures/BrickLightGrey(1).png
WE ./textures/BrickFireRed.png
EA ./textures/brick_dark_2_8.png

F 255,2,11
C 11,11,166	


   11111111111111
111     101000011
101111111111100111
1110000000000001
101N010111111111
11111111